XPX-X
I I I
X-X-X
I I I
X-X-X
I I I
X-X-X
I I I
X-X-X
I I I
X-X-X
I I I
X-X-X
I I I
XGX-X